1112113311
1        2
2  2413  2
3  4     2
1        3
1123  2  3
1       31
3 1    321
1 2  1   1
1111333111