1112113311
1        2
2  2413  2
3  3     2
1  3     3
1123322  3
1  2     1
3  1   321
1        1
1111333111